WWWWWWWW
W......W
W.WW.W.W
W....P.W
WWWWWWWW